9 9
.........
.*.......
...*.....
.....*...
......*..
.......*.
........*
.........
.........
